
strategic_region={
	id=10
	name="STRATEGICREGION_10"
	provinces={
		1627
		274 
		53 142 308 313 365 369 371 765 778 1029 1042 1104 1477 1583 1616 1655 1770 1772 3655 3676 3694 3706 3711 3720 3723 3727 3728 3732 3735 
		286 478 589 631 1050 1141 1216 1487 3730 3731 3733 3736 3738 3739 3742 3744 3745 3746 3747 3748 3749
		529 612 946 978 1034 1263 1750 1851 3675 3701 3717 3726 
		69 163 267 316 534 775 809 992 1073 1090 1186 1192 1257 1404 1513 1542 1838 3576 3581 3591 3594 3603 3608 3623 3628 3634 3643 3648 3649 3665 3687 3696 3718 3721 
		30 39 67 74 138 160 188 387 428 453 501 508 537 597 770 932 964 975 1068 1269 1291 1342 1658 3538 3574 3575 3611 3630 3631 3640 3651 3652 3660 3664 3667 3669 3688 3698 3703 3715 3722
		135 283 284 426 481 495 502 503 505 608 675 732 740 760 817 874 937 1040 1203 1305 1351 1426 3331 3335 3348 3349 3350 3373 3417 3418 3431 3435 3449 3452 3457 3459 3484 3519 3527 3555 3560 3586 
		158 225 307 403 625 633 650 665 668 717 780 905 970 1082 1096 1179 1187 1253 1298 1307 1329 1339 1495 1499 1523 1561 1707 3167 3179 3220 3239 3255 3297 3254 3282 3317 3358 3368 3389 3404 3411 3434 3437 3466 3470 3488 3499 3550 3590 3612
		75 189 664 876 1145 1278 1442 1445 1515 1566 1678 1754 3189 3227 3352 3387 3416 3441 3447 3469 3480 3487 3508 3514 3559 3602
		198
	}
	weather={
	}
}
