
strategic_region={
	id=17
	name="STRATEGICREGION_17"
	provinces={
		248 266 540 837 918 953 1168 1272 1289 1435 1608 1663 2280 2292 2308 2321 2322 2323 2340 2346 2353 2357 2358 2380 2388 2389 2394 2422 2427 2433 2448 2461 2484 2506 2536 
		752 756 1021 1172 1217 1330 1413 1518 1807 2291 2298 2331 2341 2371 2372 2373 2407 2410 2418 2423 2434 2459 2479 2491 
		436 655 758 788 795 819 861 940 1074 1237 1472 1519 1576 1606 1622 1759 2311 2312 2319 2324 2347 2368 2381 2397 2404 2444 2458 2471 2478 
		51 52 216 467 483 519 719 722 850 1030 1075 1231 1662 2499 2530 2532 2542 2564 2573 2576 2611 2638 2654 2675 2679 2703 2734 2757 
		58 109 178 222 306 330 565 627 660 926 944 969 1103 1397 1607 1621 1714 1736 1834 2522 2604 2643 2688 2696 2750 2769 
	}
	weather={
	}
}
