
strategic_region={ # states: 1 4 5 6 8 11 12 14 15 16 19 23 25 26 33 34 38 39 42 45
	id=2
	name="STRATEGICREGION_2"
	provinces={
		95 3750 
		1183 
		19 28 212 429 807 844 878 1143 1147 1150 1433 1505 1748 1966 1967 1977 1982 1984 1987 1996 1998 2000 2001 2002 2006 2009 2011 2015
		108 253 275 688 1166 1320 1614 1970 1978 1986 2007 2008 2019 2024 2033 
		686 835 2078 2079 3751
		418 887 1053 1170 1210 1229 2146 2155 2159 2172 2186 
		1429 1448 2181 2188 2193
		2252 2268 2271 
		65 123 207 750 767 1361 1781 1840 2255 2282 2304 2328 2396 2399 2405 2425 
		2370 2402 
		847 1101 2439 2463 2470 2488 2505 2519 3753
		3755 2674 
		2815 2847 
		645 1849 3756 3757 3758
		1164 1273 1501 1635 2962 2968 3007 3034 3061 3079 3080 3116 3762
		3058 3073 3123 
		278 647 826 1765 3259 3311 3355 3397
		3292 3763 
		708 792 1221 1524 1722 3729 3734 3737 3740 3743 3764 
		335 3765 3766
	}
	weather={
	}
}
