
strategic_region={
	id=20
	name="STRATEGICREGION_20"
	provinces={
		184 314 376 345 440 744 843 893 972 1209 1553 1863 1864 1865 1866 1867 1868 1871 1873 1877
		89 214 377 415 553 628 687 834 872 949 1227 1484 1880 1805 1872 1886 1889 1891 1894 1908 1913 1927 1930
		71 169 194 572 677 947 1058 1230 1331 1531 1623 1869 1870 1874 1875 1876 1878 1879 1882 1883 1884 1887
		31 92 200 273 344 351 375 473 581 622 705 736 821 934 1076 1148 1259 1328 1358 1611 1613 1656 1681 1698 1775 1808 1842 1881 1885 1888 1892 1893 1900 1902 1903 1915 1916 1924 1933 1934 1938 1939 1941 1952 1962 1980 1985 
		217 257 287 304 319 1110 1149 1158 1093 1212 1277 1637 1652 1841 1953 1960 1974 1696 1992 1995 1997 2025 2032 2042 2043 2052 2060 2072 2074 2082 2085 
		81 176 305 356 430 446 450 602 616 630 654 692 816 976 1052 1085 1146 1195 1220 1381 1558 1756 1809 1825 1937 1945 1947 1957 1965 1969 1975 1976 1999 2017 2023 2029 2034 2040 2045
		26 27 101 171 223 233 323 394 432 487 859 892 901 1302 1322 1671 1690 1710 1774 1989 1990 1991 2004 2005 2013 2030 2038 2041 2046 2051 2057 2070 2071 2077 2080 2090 
	}
	weather={
	}
}
