
strategic_region={
	id=3
	name="STRATEGICREGION_3"
	provinces={
		235 331 339 578 798 864 1078 1083 1092 1173 1244 1248 1350 1355 1560 1659 1763 1813 1846 3003 3093 3110 3150 3161 3162 3199 3205 3210 3222 3242 3265 3271 3293 3322 3341 3400  
		41 107 114 119 156 175 230 545 605 643 712 779 793 830 902 925 1174 1571 1603 1757 1821 3138 3156 3188 3206 3266 3267 3294 3309 3314 3327 3228 3336 3243 3351 
		187 279 311 556 813 890 1261 1312 1476 1529 1786 3490 3529 3539 3533 3563 3579 3596 3621 3647 3657 3671 3677 3678 3692 
		9 10 17 59 195 347 355 407 413 431 768 880 883 1006 1165 1234 1294 1386 1449 1497 1507 1590 1686 1738 1742 3304 3308 3342 3345 3385 3401 3421 3422 3423 3451 3454 3485 3486 3511 3516 3540 3551 3564 3573 3597 3613 3617 
		47 55 139 179 206 328 352 485 1242 1262 1395 1410 1494 1511 1642 1785 1792 1845 3183 3354 3264 3369 3375 3384 3420 3438 3450 3458 3475 3523 3530 3556 3569 3570 3593 3595 3604 3641
		10118 10119 10127
	}
	weather={
	}
}
