
strategic_region={
	id=4
	name="STRATEGICREGION_4"
	provinces={
		193 393 903 945 957 968 1065 1095 1224 2550 2614 2627 2673 2695 2717 2748 2755 2776 2802 2810 2829 2850 2894
		16 88 203 447 536 784 943 1154 1375 1408 1420 1492 1510 1620 2851 2861 2867 2926 2949 2953 2981 2991 3012 3028 3042 3066 3067 3094 3119 3168 3173 3200 3287 
		546 693 839 898 1059 1105 1129 1354 1436 1509 1533 1670 2660 2661 2664 2702 2712 2741 2771 2790 2791 
		32 359 455 464 526 698 912 1025 1514 1587 1665 1705 2465 2493 2513 2551 2615 2749 2650 2785 2862 2883 
		152 197 199 219 298 303 437 448 575 661 747 1362 1573 1743 2882 2899 2900 2904 2920 2939 2934 2946 2957 2963 2990 3035 3036 3037 3046 3053 3086 3102 3106 3143 3151 3152 3191 
		18 599 877 1123 1568 1610 2768 2782 2856 2895 2896 2935 2936
		1 56 310 425 443 723 806 952 979 1240 1454 1612 1633 1645 1661 1667 1719 2393 2403 2417 2441 2453 2456 2457 2476 2477 2489 2490 2492 2541 2544 2563 2570 2602 2603 2619 2637 2678 2733 2756 2811
		130 264 353 449 696 766 785 829 848 1118 1233 1563 1697 1856 2432 2440 2531 2557 2562 2464 2568 2569 2590 2599 2628 
	}
	weather={
	}
}
