
strategic_region={
	id=5
	name="STRATEGICREGION_5"
	provinces={
		60 229 271 320 409 484 621 662 818 1070 1139 1303 1403 1457 1488 1618 1712 1728 1744 1746 1780 2515 2533 2539 2566 2571 2593 2606 2655 2697 2704 2742 2778 2779 2780 2792 2818 2823 2854 2890 2927 
		174 154 261 640 748 796 799 814 860 999 1142 1069 1144 1232 1550 1688 1716 2250 2253 2263 2264 2269 2270 2275 2276 2281 2284 2285 2286 2297 2299 2315 2316 2320 2332 2326 2333 2338 2348 2349 2361 2365 2382 2398 2428 2435 2445 
		180 265 368 405 592 623 669 726 939 991 1155 1401 2350 2351 2362 2383 2384 2385 2408 2411 2419 2424 2426 2436 2446 2449 2460 2462 2481 2500 2501 2526 
		234 338 1002 1151 1188 1190 1251 1324 1349 1461 1482 1794 1799 1803 1831 1814 2552 2577 2579 2594 2632 2640 2719 2726 2737 2758 2786 2793 2794 2796 2824
		68 173 900 1416 1424 1733 2840 2875 2905 2921 2950 2964 2969 2989 
		141 419 587 626 649 763 811 865 1054 1100 1310 1306 1459 1737 1857 2472 2480 2485 2525 2565 2592 2600 2605 2630 2631 2639 2680 2681 2718 2735 2736 2777 2803 2830 
		157 218 312 950 1038 1167 1081 1084 1169 1540 1835 1843 2502 2507 2510 2520 2523 2537 2540 2553 2667 2668 2689 
		10117
	}
	weather={
	}
}
