
strategic_region={
	id=6
	name="STRATEGICREGION_6"
	provinces={
		590 1194 1347 3473 3398 3415
		289 317 471 499 582 610 639 858 987 1130 1243 1249 1308 1360 1483 1527 1547 1668 1734 1853 3386 3439 3483 3497 3503 3512 3525 3536 3537 3553 3558 3572 3583 3592 3605 3620 3624 
		527 981 1541 1713 3636 3639 3670 
		11 332 392 475 479 547 993 1215 1352 1370 1393 1437 1485 1517 1692 1693 3462 3467 3492 3496 3501 3521 3531 3535 3542 3565 3571 3587 3598 3599 3622 3635 3650 3662 3679 3686 3695 3707 3712 3719 
		254 410 420 452 493 571 727 897 1001 1285 1341 1348 1427 1589 1767 3429 3463 3502 3506 3524 3548 3552 3566 3580 3588 3614 3618 3629 3632 3642 3654  
		367 513 569 579 838 1290 1475 1549 1683 1854 3361 3433 3472 3478 3481
		3320 
		129 400 574 648 695 1200 1325 1460 1564 1793 3653 3682 3710
	}
	weather={
	}
}
