
strategic_region={
	id=7
	name="STRATEGICREGION_7"
	provinces={
		82 228 709 840 891 896 1247 1528 1715 1779 2976 3001 3047 3082 3100 3139 3145 3176 3192 3193 3201 3235 3240 3249 3272  
		580 
		383 395 586 794 797 842 909 997 1041 1094 1135 1327 1438 1536 1539 1672 1689 1745 1829 1859 2795 2797 2804 2825 2836 2841 2871 2879 2918 2922 3020 3029 3068 3118 
		136 213 277 494 1007 1268 1727 2886 2633 2651 2671 2698 2720 2805 2855 2885
		134 148 327 598 603 725 836 922 1011 1032 1108 1204 1314 1407 1414 2527 2534 2567 2572 2574 2601 2607 2641 2662 2690 2826 2852 2880
		44 272 421 456 573 682 920 1061 1185 1419 1455 1629 2884 2891 2928 2970 2971 3024 3025 3074 3075 3083 
	}
	weather={
	}
}
