
strategic_region={
	id=9
	name="STRATEGICREGION_9"
	provinces={
		15 243 315 401 550 559 594 617 786 881 1193 1201 1264 1379 1578 1703 2917 2940 2943 2982 3013 3019 3043 3054 3072 3081 3099 3107 3127 3144 3153 3158 3174 3184 3194 3212 3213 3214 3247 3258 
		132 140 435 466 604 694 869 1288 1545 1594 1771 1789 1812 3062 3071 3087 3117 3157 3207 3211 3246 3256 3257 3275  3289 3299 3300 3318 3337 3343 3346 3376  3379 3390 3392 3413 3442 3760 3761 
		86 126 231 358 381 362 399 544 561 656 931 980 994 995 1012 1049 1124 1208 1577 1644 1718 1778 1802 3295 3310 3319 3323 3347 3359 3366 3370 3391 3393 3405 3406 3443 3491 3517 3557  
		165 256 299 600 789 1080 1180 1335 1555 1570 1639 1666 1858 3333 3402 3428 3344 3461 3494 3495  
		211 346 364 516 757 810 828 1107 1385 1544 1596 1602 1647 1729 1810 1833 3328 3432 3448 3471 3477 3534 
		24 268 379 593 638 710 983 1051 1056 1140 1182 1434 1559 1586 1648 1649 1680 1824 3055 3056 3057 3111 3112 3159 3163 3169 3175 3208 3234 3248 3276 3277 3284 3324 3325 3360 3365
	}
	weather={
	}
}
