5 5 10976 6887 10959 6227 4871
5 5 10976 6887 10959 6227 4871 
3 13 9471 9458 9442 3424 9417 563 9404 5430 5845 9369 2640 251 1447 
3 15 1447 9300 1737 9299 7130 4613 2168 9343 4807 1675 5094 9308 9292 1818 2124 
3 19 2124 9258 2691 106 6663 5355 9162 2204 9142 5003 6225 6367 9118 5133 3189 9234 9262 9269 1447 
3 11 2124 5838 2387 6921 9209 5179 1257 9103 3272 4699 5877 
2 5 5179 6350 6027 9219 106 
3 7 5877 677 8955 286 4779 1224 8945 
3 4 5877 8982 8991 9016 
3 3 9016 3384 5921 
3 20 5921 6766 1153 176 8833 4433 8787 8764 6433 4610 8680 8618 2000 8581 8558 6078 247 6485 8466 4693 
3 11 5921 8998 3828 5455 8989 5477 2035 6325 4123 4061 8884 
3 25 9082 9093 1462 4838 9098 949 9163 2734 2884 9158 6535 3479 1438 9237 580 5113 9251 3320 9217 9213 9227 9201 254 9167 350 
3 4 3272 9085 9087 350 
2 4 9016 1885 9076 350 
3 3 3424 9400 9417 
1 5 9458 2607 9454 1545 9452 
1 6 9452 4980 2169 1555 526 9531 
1 5 9452 9441 6493 9425 4363 
1 4 251 9327 2093 9303 
1 5 9299 2910 4844 6627 3189 
1 3 9118 3426 213 
1 2 9234 9192 
1 11 5838 2213 9314 9332 1848 4442 9355 6760 6122 4899 9374 
1 10 5355 9152 9139 9106 9095 9061 9043 2643 2411 677 
1 8 8982 8959 5236 1845 2610 6301 8805 4433 
1 8 4433 4647 697 8806 6527 1831 6468 473 
1 4 473 5770 8725 2711 
1 13 473 8812 373 8823 3550 5958 137 6668 3326 8881 8885 8838 180 
1 3 8884 6424 8823 
1 4 8812 2285 4113 8880 
1 11 8466 6658 8480 3832 4795 8552 1577 1705 8613 8623 8618 
1 4 8613 5181 5538 8658 
1 14 1224 4197 5983 1483 6815 8767 8740 1031 6119 875 5653 191 8580 8558 
1 6 3320 2847 6310 6596 9340 1579 
1 5 3320 1980 9170 3637 9100 
1 9 580 5765 171 9161 9133 3698 9051 9027 5725 
1 6 5725 3253 8942 8923 4857 8884 
1 3 5725 5712 8999 
1 5 8999 8974 8946 4565 8881 
1 3 8999 923 4731 
1 8 8885 5103 8947 3111 5692 1602 3050 949 
1 3 5692 9059 1462 
